411111111111111111111111115
200000000000000000000000002
200000000000000000000000002
200000000000000000000000002
200000000000000000000000002
200000000000000000000000002
200000000000000000000000002
200000000000000000000000002
200000000000000000000000002
200000000000000000000000002
200000000000000000000000002
200000000000000000000000002
200000000000000000000000002
200000000000000000000000002
200000000000000000000000002
200000000000000000000000002
200000000000000000000000002
333333333333333333333333333